0 0 0 0 0 0 0 4 5 0 0 0 0 0 0 0
0 0 0 0 0 0 0 4 5 0 0 0 0 0 0 0
0 0 0 0 0 0 0 4 5 0 0 0 0 0 0 0
0 0 0 0 0 0 0 4 5 0 0 0 0 0 0 0
0 0 0 0 0 0 0 4 5 0 0 0 0 0 0 0
2 2 2 2 2 2 2 12 11 2 2 2 2 2 2 2
7 7 7 7 7 7 7 10 9 7 7 7 7 7 7 7
0 0 0 0 0 0 0 4 5 0 0 0 0 0 0 0
0 0 0 0 0 0 0 4 5 0 0 0 0 0 0 0
0 0 0 0 0 0 0 4 5 0 0 0 0 0 0 0
0 0 0 0 0 0 0 4 5 0 0 0 0 0 0 0
0 0 0 0 0 0 0 4 5 0 0 0 0 0 0 0

